magnetically	by the use of magnetism
precise	characterized by perfect conformity to fact or truth
milt	fish sperm or sperm - filled reproductive gland
pheasant	large long - tailed gallinaceous bird native to the old world but introduced elsewhere
whiting	to turn white
necromancy	the belief in magical spells that harness occult forces or evil spirits to produce unnatural effects in the world
effigy	a representation of a person especially in the form of sculpture
dear	with or in a close or intimate relationship
viaduct	bridge consisting of a series of arches supported by piers used to carry a road or railroad over a valley
neigh	to make a characteristic sound , of a horse
engraving	to carve , cut , or etch into a material or surface
plenary	full in all respects
exfoliate	to spread by opening the leaves of
bulkhead	a partition that divides a ship or plane into compartments
nonentity	the state of not existing
nitroglycerin	a liquid appearing like a heavy oil , colorless or yellowish , and consisting of a mixture of several glycerin salts of nitric acid , and hence more properly called glycerin nitrate
astray	away from the right path or direction
gaucherie	the quality of being rustic or gauche
foggy	stunned or confused and slow to react as from blows or drunkenness or exhaustion
morel	nightshade
captain	an officer holding a rank below a major but above a lieutenant
strew	to spread by scattering straw is archaic
lace	to do lacework
distractedly	in a distracted manner
varnish	a coating that provides a hard , lustrous , transparent finish to a surface
baron	a nobleman in various countries of varying rank
flask	bottle that has a narrow neck
suave	having a sophisticated charm
passage	the act of passing from one state or place to the next
tickle	to touch a body part lightly so as to excite the surface nerves and cause uneasiness , laughter , or spasmodic movements
amaze	to affect with wonder
compost	a mixture of decaying vegetation and manure
foster	providing or receiving nurture or parental care though not related by blood or legal ties
jig	to dance a quick dance with leaping and kicking motions
astrology	in its <unk> signification , the science of the stars
graven	cut into a desired shape
microscopically	by using a microscope
carburetor	mixes air with gasoline vapor prior to explosion
peavey	a stout lever with a sharp spike
informality	a manner that does not take forms and ceremonies seriously
antediluvian	of or relating to the period before the biblical flood
minder	a person who looks after babies usually in the persons own home while the babys parents are working
veranda	a porch along the outside of a building sometimes partly enclosed
geology	a science that deals with the history of the earth as recorded in rocks
infringement	a crime less serious than a felony
navigable	deep enough and wide enough to afford passage to vessels
evangel	the four books in the new testament <unk> , mark , <unk> , and john that tell the story of christs life and teachings
exception	a deliberate act of omission
precarious	affording no ease or reassurance
redact	to formulate in a particular style or language
worst	most wanting in quality or value or condition
trough	a narrow depression as in the earth or between ocean waves or in the ocean bed
telling	disclosing unintentionally
trouble	to to cause inconvenience or discomfort to
cunningly	in an attractive manner
squirt	to wet with a spurt of liquid
vouchsafe	to grant in a condescending manner
school	to swim in or form a large group of fish
sentimental	given to or marked by sentiment or sentimentality
magic	possessing or using or characteristic of or appropriate to supernatural powers
nectar	fruit juice especially when <unk>
level	not showing abrupt variations
buttonhole	to detain in conversation by or as if by holding on to the outer garments of
adorable	lovable especially in a childlike or naive way
extenuate	to lessen or to try to lessen the seriousness or extent of
triangulate	composed of or marked with triangles
piling	to arrange in stacks
thrombus	a blood clot formed within a blood vessel and remaining attached to its place of origin
admissible	deserving to be admitted
accentuation	the use or application of an accent
settle	to come to terms
trite	repeated too often
roundness	the fullness of a tone of voice
wantonness	the trait of lacking restraint or control
alms	money or goods contributed to the poor
enforce	to ensure observance of laws and rules
naturalism	the doctrine that the world can be understood in scientific terms without recourse to spiritual or supernatural explanations
logistics	handling an operation that involves providing labor and materials be supplied as needed
dexterity	adroitness in using the hands
specially	in a special manner
franc	the basic monetary unit in many countries
presidio	a fortress established in the southwestern united states by the spanish in order to protect their <unk> and other holdings
grasshopper	terrestrial plant - eating insect with hind legs adapted for leaping
pore	to direct ones attention on something
tee	the starting place for each hole on a golf course
feasibility	the quality of being doable
advertise	to call attention to
squeezer	a kitchen utensil for squeezing juice from fruit
guillotine	instrument of execution that consists of a weighted blade between two vertical poles
beseeching	begging
hamper	to prevent the progress or free movement of
milled	having the husk or outer layers removed
cutaneous	relating to or existing on or affecting the skin
twine	to make by twisting together or intertwining
sentimentalism	the excessive expression of tender feelings , nostalgia , or sadness in any form
agendum	a list of matters to be taken up as at a meeting
antecedence	preceding in time
wreck	to smash or break forcefully
sleepwalker	someone who walks about in their sleep
mathematical	of or pertaining to or of the nature of mathematics
edifice	a structure that has a roof and walls and stands more or less permanently in one place
verbalize	to be verbose
polygonal	having many sides or relating to a surface marked by <unk>
lowliness	the state of being humble and unimportant
reconstruction	the activity of constructing something again
cerium	a ductile grey metallic element of the lanthanide series
reply	to react verbally
theca	a case or sheath especially a pollen sac or moss capsule
doting	extravagantly or foolishly loving and indulgent
alertness	a state of readiness to respond
unchristian	not of a christian faith
collateral	descended from a common ancestor but through different lines
hemicycle	a plane figure with the shape of half a circle
marquise	a noblewoman ranking below a duchess and above a countess
camisole	a short sleeveless undergarment for women
malaria	marked by paroxysms of chills and fever
ornithologist	a zoologist who studies birds
elephantine	of great mass
loose	not compact or dense in structure or arrangement
jointly	in collaboration or cooperation
averment	a declaration that is made emphatically as if no supporting evidence were necessary
blockish	resembling a block in shape
inconsiderable	too small or unimportant to merit attention
aggravate	to make worse
atheroma	can obstruct blood flow
miasma	an unwholesome atmosphere
ley	a field covered with grass or herbage and suitable for grazing by livestock
impenitent	impervious to moral persuasion
shriek	to utter a shrill cry
teacher	a person whose occupation is teaching
melancholic	characterized by or causing or expressing sadness
casing	to look over , usually with the intention to rob
theorize	to construct a theory about
shove	to push roughly
thrasher	a farm machine for separating seeds or grain from the husks and straw
dusty	covered with a layer of dust
shift	to change place or direction
settler	a person who settles in a new colony or moves into new country
symbol	an arbitrary sign written or printed that has acquired a conventional significance
elixir	a sweet flavored liquid usually containing a small amount of alcohol used in compounding medicines to be taken by mouth in order to mask an unpleasant taste
adulterer	fully developed
chipper	having a cheerful , lively , and self - confident air
overseer	a person who directs and manages an organization
suitable	meant or adapted for an occasion or use
changer	a person who changes something
influx	the process of flowing in
whimsical	determined by chance or impulse or whim rather than by necessity or reason
purview	the range of interest or activity that can be anticipated
blooming	informal intensifiers
inflammation	a response of body tissues to injury or irritation
danger	the condition of being susceptible to harm or injury
vitals	a bodily organ that is essential for life
apprehensive	quick to understand
regeneration	growth anew of lost tissue or destroyed parts or organs
bullock	young bull
improbable	not likely to be true or to occur or to have occurred
snug	offering safety
pliers	a gripping hand tool with two hinged arms and usually serrated jaws
marker	some conspicuous object used to distinguish or mark something
forefront	the part in the front or nearest the viewer
removal	the act of removing
sawbuck	a framework for holding wood that is being sawed
sermon	an address of a religious nature usually delivered during a church service
abase	to cause to feel shame
terminal	of or relating to or situated at the ends of a delivery route
conventional	following accepted customs and proprieties
fee	to give a tip or gratuity to in return for a service , beyond the compensation agreed on
cabala	a kind of occult theosophy or traditional interpretation of the scriptures among jewish rabbis and certain medi Ã¦ val christians , which treats of the nature of god and the mystery of human existence
apportionment	the act of distributing by allotting or apportioning
distinct	easy to perceive
huskiness	the property of being big and strong
derisory	incongruous
visit	to go to see a place , as for entertainment
seamless	not having or joined by a seam or seams
cretaceous	abounding in chalk
bleed	to draw blood
bigness	the property of having a relatively great size
halogen	chlorine fluorine bromine and iodine
prey	a person who is the aim of an attack especially a victim of ridicule or exploitation by some hostile person or influence
memory	something that is remembered
rationalism	the doctrine that knowledge is acquired by reason without resort to experience
fez	a city in north central morocco
pistil	the female ovule - bearing part of a flower composed of ovary and style and stigma
atrophied	diminished in size or strength as a result of disease or injury or lack of use
trophy	an award for success in war or hunting
applicable	capable of being applied
sensorium	the areas of the brain that process and register incoming sensory information and make possible the conscious awareness of the world
infamy	a state of extreme dishonor
pugilism	fighting with the fists
beholder	a person who becomes aware of things or events through the senses
mesmerize	to attract strongly , as if with a magnet
apparent	clearly revealed to the mind or the senses or judgment
grief	intense sorrow caused by loss of a loved one especially by death
textile	of or relating to fabrics or fabric making
oleaginous	unpleasantly and excessively suave or ingratiating in manner or speech
mellow	having a full and pleasing flavor through proper <unk>
dapple	to colour with streaks or blotches of different shades
mascot	a person or animal that is adopted by a team or other group as a symbolic figure
leaper	someone who bounds or leaps as in competition
keeping	to keep in a certain state , position , or activity
primate	any placental mammal of the order primates
pout	to make a sad face and thrust out ones lower lip
meed	a fitting reward
legation	the post or office of legate
accomplishment	the action of accomplishing something
caw	to cry like a crow , rook , or raven
botheration	the psychological state of being irritated or annoyed
infinitesimal	infinitely or immeasurably small
solitaire	a gem usually a diamond in a setting by itself
cam	a rotating disk shaped to convert circular into linear motion
learn	to gain knowledge or skills
meet	being precisely fitting and right
obsolete	no longer in use
passivity	the trait of remaining inactive
detritus	loose material stone fragments and silt etc that is worn away from rocks
dosage	the quantity of an active agent substance or radiation taken in or absorbed at any one time
aggrandize	to add details to
decorative	serving an esthetic rather than a useful purpose
shark	to act with trickery
iodine	a nonmetallic element belonging to the halogens
eros	a desire for sexual intimacy
apocalyptic	of or relating to an apocalypse
household	a social unit living together
eczema	generic term for inflammatory conditions of the skin
statics	the branch of mechanics concerned with forces in equilibrium
chit	a dismissive term for a girl who is immature or who lacks respect
disparagement	a communication that belittles somebody or something
impair	to make worse or less effective
regale	to provide with choice or abundant food or drink
untruthful	not expressing or given to expressing the truth
chic	elegant and stylish
distressful	causing distress or worry or anxiety
preferably	more readily or willingly
filter	to pass through
procurer	someone who obtains or acquires
memorize	to commit to memory
lame	<unk> lacking in force or effectiveness
sailboat	a small sailing vessel
justifiable	capable of being justified
scarceness	a small and inadequate amount
syphilis	symptoms change through progressive stages
clement	physically mild
exalted	of high moral or intellectual value
vital	performing an essential function in the living body
criterion	the ideal in terms of which something can be judged
pederasty	sexual relations between a man and a boy usually anal intercourse with the boy as a passive partner
reject	to refuse to accept or acknowledge
clink	to make a high sound typical of glass
persuasion	the act of persuading or attempting to persuade
divider	a person who separates something into parts or groups
accused	to bring an accusation against
watery	filled with water
massacre	to kill a large number of people indiscriminately
doable	capable of existing or taking place or proving true
starless	not starry
loyalty	the quality of being loyal
campaigner	a politician who is running for public office
underhand	with hand brought forward and up from below shoulder level
explicate	to elaborate , as of theories and hypotheses
wrong	contrary to conscience or morality or law
plane	having a surface without slope , tilt in which no part is higher or lower than another
finality	the quality of being final or definitely settled
prance	to spring forward on the hind legs
faculty	one of the inherent cognitive or perceptual powers of the mind
misfit	someone unable to adapt to their circumstances
hedonism	the pursuit of pleasure as a matter of ethical principle
cabbage	to make off with belongings of others
foremost	preceding all others in spatial position
coiner	a maker of counterfeit coins
cribbage	a game of cards , played by two or four persons , in which there is a crib
penitentiary	showing or constituting penance
chute	to jump from an airplane and descend with a parachute
bung	to close with a cork or stopper
manic	affected with or marked by frenzy or mania uncontrolled by reason
light	of comparatively little physical weight or density
nomadic	migratory
caisson	a two - wheeled military vehicle carrying artillery ammunition
rowdy	disturbing the public peace
ablution	the ritual washing of a priests hands or of sacred vessels
blunder	to make ones way clumsily or blindly
pastorate	the position of pastor
bursar	the treasurer at a college or university
haste	overly eager speed and possible carelessness
deposit	to put into a bank account
deafening	loud enough to cause temporary hearing loss
pay	to give money , usually in exchange for goods or services
alloy	to lower in value by increasing the base - metal content
bushel	to restore by replacing a part or putting together what is torn or broken
retrieval	the act of regaining or saving something lost or in danger of becoming lost
idiosyncratic	peculiar to the individual
restriction	a principle that limits the extent of something
salon	gallery where works of art can be displayed
viand	a choice or delicious dish
toddy	a mixed drink made of liquor and water with sugar and spices and served hot
pelican	large long - winged warm - water seabird having a large bill with a <unk> pouch for fish
consent	to give an affirmative reply to
distortion	a change for the worse
embezzlement	the fraudulent appropriation of funds or property entrusted to your care but actually owned by someone else
cotter	a peasant farmer in the scottish highlands
stile	an upright that is a member in a door or window frame
tyrant	a cruel and oppressive dictator
repletion	the state of being satisfactorily full and unable to take on more
suffer	to undergo or be subjected to
airing	to expose to fresh air
tendency	a characteristic likelihood of or natural disposition toward a certain condition or character or effect
playhouse	plaything consisting of a small model of a house that children can play inside of
fir	chiefly of upland areas
anonymously	without giving a name
muskrat	beaver - like aquatic rodent of north america with dark glossy brown fur
exultant	joyful and proud especially because of triumph or success
equanimity	steadiness of mind under stress
overbalance	to cause to be off balance
pray	to address a deity , a prophet , a saint or an object of worship
inward	relating to or existing in the mind or thoughts
colliery	a workplace consisting of a coal mine plus all the buildings and equipment connected with it
undress	to get undressed
labor	to work hard
voiced	produced with vibration of the vocal cords
disclosed	made known especially something secret or concealed
rancidity	the state of being rancid
lard	to add details to
sauce	to behave saucily or impudently towards
angled	forming or set at an angle
hobnail	a short nail with a thick head
noncommittal	refusing to bind oneself to a particular course of action or view or the like
bountiful	producing in abundance
adjacent	nearest in space or position
disparate	fundamentally different or distinct in quality or kind
entire	constituting the full quantity or extent
propose	to make a proposal , declare a plan for something
unreal	lacking in reality or substance or genuineness
insomnia	an inability to sleep
rockfish	the lean flesh of any of various valuable market fish caught among rocks
miscible	capable of being mixed
respire	to breathe easily again , as after exertion or anxiety
sessile	permanently attached to a <unk>
stout	dependable
identically	with complete identity
dad	an informal term for a father
baking	as hot as if in an oven
disburse	to expend , as from a fund
investor	someone who commits capital in order to gain financial returns
presidential	relating to a president or presidency
lineage	the descendants of one individual
gloom	a state of partial or total darkness
huddle	to crowd or draw together
placate	to cause to be more favorably inclined
blazer	lightweight single - breasted jacket
spigot	a plug for a <unk> in a cask
opine	to express ones opinion openly and without fear or hesitation
delicate	exquisitely fine and subtle and pleasing
nauseous	causing or able to cause nausea
chuck	to throw carelessly
crudely	in a crude or unrefined manner
bless	to give a benediction to
tear	to separate or cause to separate abruptly
destructively	in a destructive manner
summarily	without delay
congruity	the quality of agreeing
instrumentality	a subsidiary organ of government created for a special purpose
airiness	the property of something spacious and abounding in fresh air
dishonorable	lacking honor or integrity
harm	any physical damage to the body caused by violence or accident or fracture etc .
malfeasance	wrongful conduct by a public official
pliant	capable of being influenced or formed
farce	to fill with a stuffing while cooking
prepuce	a fold of skin covering the tip of the clitoris
torch	to burn maliciously , as by arson
spider	they spin silk to make cocoons for eggs or traps for prey
related	being connected either logically or causally or by shared characteristics
bovine	of or relating to or belonging to the genus bos cattle
avulsion	an abrupt change in the course of a stream that forms the boundary between two parcels of land resulting in the loss of part of the land of one landowner and a consequent increase in the land of another
steeper	having a sharp inclination
ductile	easily influenced
trading	to engage in the trade of
turnkey	someone who guards prisoners
stealing	to take without the owners consent
doubtful	open to doubt or suspicion
paranoiac	a person afflicted with paranoia
intricately	with elaboration
minority	being or relating to the smaller in number of two parts
magnet	a device that attracts iron and produces a magnetic field
ditch	to forsake
actively	in an active manner
impurity	worthless or dangerous material that should be removed
sentiment	tender , romantic , or nostalgic feeling or emotion
perfume	to fill or impregnate with an odor
transcript	something that has been transcribed
abide	to dwell
reverend	worthy of adoration or reverence
lucifer	chief spirit of evil and adversary of god
hearken	to listen
brindled	having a grey or brown streak or a pattern or a patchy coloring
ingathering	request for a sum of money
honorable	worthy of being honored
sliding	being a smooth continuous motion
busybody	one who officiously concerns himself with the affairs of others
insular	relating to or characteristic of or situated on an island
redevelop	to develop for a second time , in order to improve the contrast , colour , etc ., of a negative or print
dorsally	in a dorsal location or direction
ossify	to become bony
philharmonic	composing or characteristic of an orchestral group
pathogenic	able to cause disease
sideways	at an angle
discontinuity	lack of connection or continuity
barreled	put in or stored in a barrel
mourning	sorrowful through loss or deprivation
clarify	to make clear and more comprehensible
demonic	extremely evil or cruel
peevishness	an irritable petulant feeling
mullet	freshwater or coastal food fishes a spindle - shaped body
beginning	serving to begin
acrobat	an athlete who performs acts requiring skill and agility and coordination
humanist	of or pertaining to a philosophy asserting human dignity and mans capacity for fulfillment through reason and scientific method and often rejecting religion
malediction	the act of calling down a curse that <unk> evil and usually serves as an insult
underwear	undergarment worn next to the skin and under the outer garments
unstrained	not placed under psychological stress
contemplation	a long and thoughtful observation
hostile	characterized by enmity or ill will
carnival	a festival marked by merrymaking and processions
recast	to cast again , in a different role
basso	an adult male singer with the lowest voice
obstacle	that which stands in the way , or opposes
lingual	pertaining to or resembling or lying near the tongue
steward	someone who manages property or other affairs for someone else
silicon	a tetravalent nonmetallic element
illicit	contrary to accepted morality especially sexual morality or convention
wither	to lose freshness , vigor , or vitality
prejudice	to influence somebodys opinion in advance
knickers	trousers ending above the knee
soda	a sodium salt of carbonic acid
heckle	to challenge aggressively
loudness	the magnitude of sound usually in a specified direction
skinflint	a selfish person who is unwilling to give or spend
legality	lawfulness by virtue of conformity to a legal statute
botany	the branch of biology that studies plants
artistry	a superior skill that you can learn by study and practice and observation
shrewish	having the qualities of a shrew
platonic	of or relating to or characteristic of plato or his philosophy
forwards	at or to or toward the front
striking	sensational in appearance or thrilling in effect
distal	situated farthest from point of attachment or origin , as of a limb or bone
vainglorious	feeling self - importance
reciprocally	in exchange or in reciprocation
crib	to take unauthorized intellectual material
larboard	located on the left side of a ship or aircraft
lettuce	any of various plants of the genus lactuca
punishable	liable to or deserving punishment
directly	without deviation
feldspar	any of a group of hard crystalline minerals that consist of aluminum silicates of potassium or sodium or calcium or barium
rind	the natural outer covering of food usually removed before eating
custom	made according to the specifications of an individual
open	affording unobstructed entrance and exit
pauper	a person who is very poor
engineer	to plan and direct a complex undertaking
vixen	a malicious woman with a fierce temper
sheet	to come down as if in sheets
exchequer	the funds of a government or institution or individual
district	to regulate housing in
indulgent	characterized by or given to yielding to the wishes of someone
probity	complete and confirmed integrity
authentic	conforming to fact and therefore worthy of belief
antispasmodic	a drug used to relieve or prevent spasms especially of the smooth muscles
pleura	the thin serous membrane around the lungs and inner walls of the chest
revive	to be brought back to life , consciousness , or strength
realistically	in a realistic manner
wrest	to obtain by seizing forcibly or violently , also metaphorically
besiege	to surround so as to force to give up
gainful	yielding a fair profit
ticklish	difficult to handle
scant	less than the correct or legal or full amount often deliberately so
submersion	the act of wetting something by submerging it
challenge	to take exception to
motility	ability to move spontaneously and independently
flume	watercourse that consists of an open artificial chute filled with water for power or for carrying logs
bumble	to speak haltingly
skullcap	the dome of the skull
smolder	to burn slowly and without a flame
accurately	with few mistakes
immediate	having no intervening medium
feint	to deceive by a mock action
cheaply	in a cheap manner
dyne	the unit of force , in the c
bower	a framework that supports climbing plants
eyed	often used in combination
vas	a tube in which a body fluid circulates
taxable	subject to taxation
portend	to indicate by signs
heretical	characterized by departure from accepted beliefs or standards
omen	to indicate by signs
spoiler	a candidate with no chance of winning but who may draw enough votes to prevent one of the leading candidates from winning
clairvoyance	apparent power to perceive things that are not present to the senses
scrumptious	extremely pleasing to the sense of taste
dower	to furnish with an endowment
spitter	one who ejects saliva from the mouth
bitterness	a rough and bitter manner
proneness	being disposed to do something
serf	a person who is bound to the land and owned by the feudal lord
compensation	something such as money given or received as payment or reparation as for a service or loss or injury
defense	military action or resources protecting a country against potential enemies
eastward	moving toward the east
pulsate	to expand and contract rhythmically
arboreal	inhabiting or frequenting trees
counselor	someone who gives advice about problems
medullary	containing or consisting of or resembling bone marrow
companionable	suggestive of companionship
ingenious	possessed of genius , or the faculty of invention
flitter	to move back and forth very rapidly
lullaby	a quiet song intended to lull a child to sleep
fashion	characteristic or habitual practice
surname	the name used to identify the members of a family as distinguished from each members given name
rend	to tear or be torn violently
questionnaire	a form containing a set of questions
danish	of or relating to or characteristic of denmark or the danes or their language
polemic	of or involving dispute or controversy
slat	to equip or bar with slats
modern	since the middle ages
abyssal	resembling an abyss in depth
balsam	an ointment containing a fragrant resin
unlikely	has little chance of being the case or coming about
twiddle	to manipulate , as in a nervous or unconscious manner
flatness	a want of animation or brilliance
sounding	having volume or deepness
screw	to cause to penetrate , as with a circular motion
lumpy	having lumps
chessboard	a checkerboard used to play chess
fanatic	marked by excessive enthusiasm for and intense devotion to a cause or idea
mechanism	the atomic process that occurs during a chemical reaction
elation	an exhilarating psychological state of pride and optimism
humanize	to make more humane
acquirer	a person who acquires something usually permanently
acuteness	a sensitivity that is keen and highly developed
detector	any device that receives a signal or stimulus as heat or pressure or light or motion etc . and responds to it in a distinctive manner
decadence	the state of being degenerate in mental or moral qualities
rider	a traveler who actively rides an animal as a horse or camel
princess	a female member of a royal family other than the queen especially the daughter of a sovereign
aspen	any of several trees of the genus populus having leaves on flattened stalks so that they flutter in the lightest wind
passionately	with passion
quote	to repeat a passage from
harmonious	musically pleasing
peek	to throw a glance at
debonair	having a sophisticated charm
insanity	relatively permanent disorder of the mind
harmful	causing or capable of causing harm
yawn	to be wide open
abut	to lie adjacent to another or share a boundary
swampy	soft and watery
negro	relating to or characteristic of or being a member of the traditional racial division of mankind having brown to black pigmentation and tightly curled hair
rationale	an explanation of the fundamental reasons especially an explanation of the working of some device in terms of laws of nature
billow	to rise up as if in waves
barbarism	a brutal barbarous savage act
voluptuary	displaying luxury and furnishing gratification to the senses
weeper	a person who weeps
nutritive	of or providing nourishment
glow	to emit a steady even light without flames
jocularity	a feeling facetious merriment
democratic	characterized by or advocating or based upon the principles of democracy or social equality
surprising	causing surprise or wonder or amazement
incase	to enclose in , or as if in , a case
moonshine	to distill alcohol illegally
bugaboo	a source of concern
napkin	a small piece of table linen that is used to wipe the mouth and to cover the lap in order to protect clothing
outfit	to provide with something usually for a specific purpose
remold	to cast again
preclude	to make impossible , especially beforehand
charitable	relating to or characterized by charity
outspread	fully extended in width
readjust	to adjust anew
entertaining	agreeably diverting
sinner	a person who sins without repenting
surrey	a light four - wheeled horse - drawn carriage
perseverance	the act of persisting or persevering
flyblown	spoiled and covered with eggs and larvae of flies
shot	varying in color when seen in different lights or from different angles
gold	a soft yellow malleable ductile trivalent and univalent metallic element
hipped	having hips
interdiction	authoritative prohibition
slashed	patterned by having color applied with sweeping strokes
dearness	the quality possessed by something with a great price or value
intone	to utter monotonously and repetitively and rhythmically
dupe	to fool or hoax
trespass	to enter unlawfully on someones property
diametric	related to or along a diameter
shod	used of certain religious orders who wear shoes
felon	a purulent infection at the end of a finger or toe in the area surrounding the nail
static	showing little if any change
loamy	consisting of or having the character of loam
trivial	small and of little importance
availability	the quality of being at hand when needed
tachometer	measuring instrument for indicating speed of rotation
testis	one of the two male reproductive glands that produce spermatozoa and secrete <unk>
untimely	badly timed
planter	the owner or manager of a plantation
buss	to touch with the lips or press the lips against someones mouth or other body part as an expression of love , greeting , etc .
ingloriously	in a dishonorable manner or to a dishonorable degree
jolt	to move or cause to move with a sudden jerky motion
emancipate	to give equal rights to
sacrilege	blasphemous behavior
preternatural	surpassing the ordinary or normal
perspicuous	transparently clear
rabbi	spiritual leader of a jewish congregation
constabulary	the force of policemen and officers
contortionist	an acrobat able to twist into unusual positions
amplify	to increase the volume of
elysian	being of such surpassing excellence as to suggest inspiration by the gods
beamy	broad in the beam
fossil	the remains or an impression of a plant or animal that existed in a past geological age and that has been excavated from the soil
cantankerous	having a difficult and contrary disposition
fatherly	like or befitting a father or fatherhood
custodian	one having charge of buildings or grounds or animals
flagellate	having or resembling a lash or whip as does a flagellum
clang	to make a loud noise
resent	to feel bitter or indignant about
dissolvable	capable of dissolving
demigod	a person with great powers and abilities
theft	the act of taking something from someone unlawfully
mope	to move around slowly and aimlessly
tungsten	a heavy grey - white metallic element
buhl	an inlaid furniture decoration
juggle	to influence by slyness
stroll	to walk leisurely and with no apparent aim
monogram	a graphic symbol consisting of 2 or more letters combined usually your initials
grandiloquence	high - flown style
evolution	the sequence of events involved in the evolutionary development of a species or taxonomic group of organisms
igneous	produced under conditions involving intense heat
suffrage	a legal right <unk> by the 15th amendment to the us constitution
borrow	to get temporarily
egoism	the theory that the pursuit of your own welfare in the basis of morality
thalamus	a mass of nervous matter on either side of the third ventricle of the brain
nickelodeon	a cabinet containing an automatic record player
cantabile	smooth and flowing
allegation	a formal accusation against somebody often in a court of law
revocation	the state of being cancelled or annulled
river	a large natural stream of water larger than a creek
homeopathy	a method of treating disease with small amounts of remedies that , in large amounts in healthy people , produce symptoms similar to those being treated
silently	without speaking
concatenate	to combine two strings to form a single one
pneumatic	of or relating to or using air or a similar gas
proximal	situated nearest to point of attachment or origin
pebbly	abounding in small stones
diminutive	very small
venter	a speaker who expresses or gives vent to a personal opinion or grievance
testing	to put to the test , as for its quality , or give experimental use to
module	detachable compartment of a spacecraft
peroration	a flowery and highly rhetorical oration
see	to perceive by sight or have the power to perceive by sight
unfit	below the required standards for a purpose
dragon	a creature of <unk> mythology
culpable	deserving blame or censure as being wrong or evil or injurious
changeable	such that alteration is possible
tiptoe	to walk on ones toes
diver	someone who works underwater
professed	professing to be qualified
ability	the quality of being able to perform
bunting	to hit a ball in such a way so as to make it go a short distance
mechanically	in a mechanical manner
dweller	a person who inhabits a particular place
definite	precise
continually	seemingly without interruption
state	to express in words
irk	to irritate or vex
myriad	too numerous to be counted
disprove	to prove to be false
props	to support by placing against something solid or rigid
affecting	arousing affect
probably	with considerable certainty
boundary	the line or plane indicating the limit or extent of something
unconscionable	lacking a conscience
numerous	amounting to a large indefinite number
pirate	to copy illegally
pictured	seen in the mind as a mental image
verification	an affidavit attached to a statement confirming the truth of that statement
commute	to exchange positions without a change in value
wage	to carry on wars , battles , or campaigns
nasturtium	aquatic herbs
avow	to admit openly and bluntly
misstep	an unintentional but embarrassing blunder
statistically	with respect to statistics
controllable	capable of being controlled
ignorance	the lack of knowledge or education
ape	to imitate uncritically and in every aspect
larynx	a cartilaginous structure at the top of the trachea
remedial	tending or intended to rectify or improve
overcharge	to rip off
punt	to kick the ball
correspondence	communication by the exchange of letters
flowering	having a flower or bloom
weary	physically and mentally fatigued
tangible	perceptible by the senses especially the sense of touch
glide	to fly in or as if in a glider plane
tractable	easily managed controlled or taught or molded
bray	to laugh loudly and harshly
annual	completing its life cycle within a year
dedicate	to open to public use , as of a highway , park , or building
quadruped	having four feet
delusory	causing one to believe what is not true or fail to believe what is true
loudly	with relatively high volume
mane	long coarse hair growing from the crest of the animals neck
spiritless	lacking ardor or vigor or energy
asceticism	the doctrine that through renunciation of worldly pleasures it is possible to achieve a high spiritual or intellectual state
genus	a general kind of something
tinning	to plate with tin
messiah	any expected deliverer
eradicate	to kill in large numbers
wale	a raised mark on the skin as produced by the blow of a whip
loaf	to be lazy or idle
flier	someone who travels by air
honeycombed	pitted with cell - like cavities as a honeycomb
separation	the state of lacking unity
breakneck	moving at very high speed
puritan	someone who adheres to strict religious principles
foreboding	to make a prediction about
epidemic	of disease or anything resembling a disease
mullion	a slender bar or pier which forms the division between the lights of windows , screens , etc
accusation	a formal charge of wrongdoing brought against a person
stillborn	showing no signs of life at birth
badminton	a game played on a court with light long - handled rackets used to volley a shuttlecock over a net
puerility	the state of a child between infancy and adolescence
incandescent	emitting light as a result of being heated
freak	to lose ones nerve
arsenic	used in manufacturing glass and as a pesticide rat poison and weed killer
snag	to get by acting quickly and smartly
grazing	to feed as in a meadow or pasture
mezzo	a soprano with a voice between soprano and contralto
gypsum	a mineral consisting of the hydrous sulphate of lime ( calcium )
underworld	the criminal class
beef	to complain
trajectory	the path followed by an object moving through space
damp	slightly wet
lumpish	mentally sluggish
freestone	fruit especially peach whose flesh does not adhere to the pit
detrimental	causing harm or injury
chambered	to place in a chamber
mockingly	in a disrespectful jeering manner
glucose	a monosaccharide sugar that has several forms
artisan	a skilled worker who practices some trade or handicraft
hyacinth	a red transparent variety of zircon used as a gemstone
conversational	characteristic of informal spoken language or conversation
chalet	a swiss house with a sloping roof and wide eaves or a house built in this style
proclivity	a natural inclination
devilish	showing the cunning or ingenuity or wickedness typical of a devil
sag	to droop , sink , or settle from or as if from pressure or loss of tautness
butchery	the business of a butcher
inconsolable	sad beyond comforting
polytheism	belief in multiple gods
chase	to go after with the intent to catch
limelight	a focus of public attention
gag	to prevent from speaking out
hernia	a protrusion , consisting of an organ or part which has escaped from its natural cavity , and projects through some natural or accidental opening in the walls of the latter
thing	a special situation
careful	exercising caution or showing care or attention
spin	to revolve quickly and repeatedly around ones own axis
mournful	expressing sorrow
feelingly	with great feeling
tide	to rise or move forward
inhibit	to limit the range or extent of
coquetry	playful behavior intended to arouse sexual interest
exaction	act of demanding or levying by force or authority
invigorate	to impart vigor , strength , or vitality to
slumber	to be asleep
admissibility	acceptability by virtue of being admissible
nothingness	the state of nonexistence
homebound	confined usually by illness
hypertrophy	abnormal enlargement of a body part or organ
aim	to point or cause to go blows , weapons , or objects such as photographic equipment towards
reliability	the quality of being dependable or reliable
watercourse	natural or artificial channel through which water flows
endanger	to pose a threat to
advisable	worthy of being recommended or suggested
alluvium	clay or silt or gravel carried by rushing streams and deposited where the stream slows down
flintlock	an obsolete gunlock that has flint embedded in the hammer
biliary	relating to the bile ducts or the <unk>
souse	to become drunk or drink excessively
bivalent	used of homologous chromosomes associated in pairs in <unk>
debased	lowered in value
alcoholic	characteristic of or containing alcohol
unction	excessive but superficial compliments given with affected charm
diversification	the act of introducing variety especially in investments or in the variety of goods and services offered
delusion	an erroneous belief that is held in the face of evidence to the contrary
tress	a <unk> formed by braiding or twisting the hair
consequent	following or accompanying as a consequence
disjoint	having no elements in common
frieze	an architectural ornament consisting of a horizontal sculptured band between the architrave and the cornice
headway	forward movement
anastomosis	a natural or surgical joining of parts or branches of tubular structures so as to make or become continuous
whorl	a round shape formed by a series of concentric circles as formed by leaves or flower petals
regression	a defense mechanism in which you flee from reality by assuming a more infantile state
candied	preserved by coating with or allowing to absorb sugar
kosher	conforming to dietary laws
pas	a step in dancing especially in classical ballet
productivity	the ratio of the quantity and quality of units produced to the labor per unit of time
ductility	the malleability of something that can be drawn into threads or wires or hammered into thin sheets
blasphemous	grossly irreverent toward what is held to be sacred
squiggle	a short twisting line
cross	extending or lying across
quagmire	a soft wet area of low - lying land that sinks underfoot
romance	relating to languages derived from latin
masquerade	to pretend to be someone or something that you are not
grapple	to to grip or seize , as in a wrestling match
clammy	unpleasantly cool and humid
plater	a skilled worker who coats articles with a film of metal usually silver or gold
catarrhal	of or relating to a catarrh
negotiate	to succeed in passing through , around , or over
finite	bounded or limited in magnitude or spatial or temporal extent
feminine	associated with women and not with men
berry	to pick or gather berries
stamen	the male reproductive organ of a flower
decedent	someone who is no longer alive
grail	the object of any prolonged endeavor
indemnity	protection against future loss
trebuchet	an engine that provided medieval artillery used during <unk>
commode	a plumbing fixture for defecation and urination
banter	to be silly or tease one another
buzz	to make a buzzing sound
refit	to fit out again
mineralogist	a scientist trained in mineralogy
warden	the chief official in charge of a prison
trawler	a fisherman who use a trawl net
wrongly	without justice or fairness
nickname	a familiar name for a person often a shortened version of a persons given name
endearing	lovable especially in a childlike or naive way
planted	set in the soil for growth
adjudicate	to put on trial or hear a case and sit as the judge at the trial of
minimize	to make small or insignificant
halve	to divide by two
legitimately	in a manner acceptable to common custom
cut	separated into parts or laid open or penetrated with a sharp edge or instrument
banging	very large
grind	to dance by rotating the pelvis in an <unk> suggestive way , often while in contact with ones partner such that the dancers legs are interlaced
deliverable	suitable for or ready for delivery
brood	to think moodily or anxiously about something
grubby	thickly covered with ingrained dirt or soot
auditor	a student who attends a course but does not take it for credit
oft	many times at short intervals
clearance	the distance by which one thing clears another
essential	basic and fundamental
prevention	the act of preventing
parody	a composition that imitates or misrepresents somebodys style , usually in a humorous way
restore	to return to its original or usable and functioning condition
arming	to prepare oneself for a military confrontation
excise	to remove by cutting
reliant	relying on another for support
abominate	to find repugnant
grouse	to complain
kali	burned to produce a crude soda ash
litterateur	a writer of literary works
slippage	a decrease of transmitted power in a mechanical system caused by slipping
guano	the excrement of sea birds
acknowledge	to report the receipt of
rodent	relatively small placental mammals having a single pair of constantly growing incisor teeth specialized for gnawing
accumulate	to collect or gather
exorbitance	excessive excess
fishing	to seek indirectly
comprehensively	in an all - inclusive manner
vamp	to make up
plight	to give to in marriage
macroscopic	visible to the naked eye
distend	to cause to expand as it by internal pressure
smite	to inflict a heavy blow on , with the hand , a tool , or a weapon
kindness	a kind act
gentleness	acting in a manner that is gentle and mild and even - tempered
clergyman	a member of the clergy and a spiritual leader of the christian church
tablet	a slab of stone or wood suitable for bearing an inscription
infinitely	continuing forever without end
informal	not formal
furry	covered with a dense coat of fine silky hairs
sinuous	curved or curving in and out
exceed	to be greater in scope or size than some standard
tormenter	a flat at each side of the stage to prevent the audience from seeing into the wings
shingles	eruptions along a nerve path often accompanied by severe neuralgia
orchestra	seating on the main floor in a theater
teller	an official appointed to count the votes especially in legislative assembly
exempt	freed from or not subject to an obligation or liability as e . g . taxes to which others or other things are subject
prominently	in a prominent way
juvenility	lacking and evidencing lack of experience of life
disadvantage	to hinder , harm
kick	to drive or propel with the foot
raven	to obtain or seize by violence
extrusion	squeezing out by applying pressure
chisel	to engage in deceitful behavior
anchovy	tiny fishes usually canned or salted
valueless	of no value
omnipotence	the state of being omnipotent
susceptibility	the state of being susceptible
testy	easily irritated or annoyed
seamy	showing a seam
ultramarine	of a brilliant pure blue to purplish blue color
displace	to cause to move , usually with force or pressure
unveil	to remove the veil from
dark	devoid of or deficient in light or brightness
earnest	characterized by a firm and humorless belief in the validity of your opinions
corporeality	the quality of being physical
press	to exert pressure or force to or upon
partridge	flesh of either quail or grouse
desperately	in intense despair
opprobrium	state of disgrace resulting from public abuse
reap	to gather , as of natural products
fryer	flesh of a medium - sized young chicken suitable for frying
moody	subject to sharply varying moods
frolic	to play boisterously
standstill	a situation in which no progress can be made or no advancement is possible
installment	a payment of part of a debt
fistula	an abnormal passage leading from a suppurating cavity to the body surface
bodkin	usually with an ornamental head
tutorship	teaching pupils individually usually by a tutor hired privately
hygiene	a condition promoting sanitary practices
strife	bitter conflict
telephony	transmitting speech at a distance
collect	payable by the recipient on delivery
pintle	a pin or bolt forming the pivot of a hinge
mescal	a small spineless globe - shaped cactus
gamecock	a cock bred and trained for fighting
bunch	to gather or cause to gather into a cluster
diapason	either of the two main stops on a pipe organ
voluntarily	out of your own free will
preoccupation	the mental state of being preoccupied by something
sprain	a painful injury to a joint caused by a sudden <unk> of its <unk>
alimentary	of or providing nourishment
sketch	to describe roughly or briefly or give the main points or summary of
taffy	chewy candy of sugar or syrup boiled until thick and pulled until glossy
creek	a natural stream of water smaller than a river and often a tributary of a river
dovish	opposed to war
detraction	a petty disparagement
debilitate	to make weak
sorbet	an ice containing no milk but having a mushy consistency
tournament	a sporting competition in which contestants play a series of games to decide the winner
maxim	a saying that is widely accepted on its own merits
hail	to be a native of
incriminate	to suggest that someone is guilty
ornament	something used to beautify
shortcoming	a failing or deficiency
interment	the ritual placing of a corpse in a grave
duration	the period of time during which something continues
pain	to cause emotional anguish or make miserable
indirect	not direct in spatial dimension
unrivaled	eminent beyond or above comparison
spasm	a painful and involuntary muscular contraction
ungracious	lacking charm and good taste
choir	a chorus that sings as part of a religious ceremony
floral	relating to or associated with flowers
eel	an elongate fish found in fresh water in europe and america
superhuman	above or beyond the human or demanding more than human power or endurance
intensifier	a modifier that has little meaning except to intensify the meaning it modifies
exceeding	far beyond what is usual in magnitude or degree
absolution	the condition of being formally forgiven by a priest in the sacrament of penance
percolate	to spread gradually
allegory	an expressive style that uses fictional characters and events to describe some subject by suggestive resemblances
songstress	a woman songster especially of popular songs
legate	a member of a legation
comestible	suitable for use as food
mitotic	of or relating to or undergoing mitosis
fretted	having frets
measuring	to determine the measurements of something or somebody , take measurements of
eyeglass	lens for correcting defective vision in one eye
thinly	without force or sincere effort
bole	a soft oily clay used as a pigment especially a reddish brown pigment
butterfish	any of numerous small flat atlantic food fish having smooth skin
marketing	to engage in the commercial promotion , sale , or distribution of
solecism	a socially awkward or tactless act
strangles	to kill by squeezing the throat of so as to cut off the air
imminence	the state of being imminent and liable to happen soon
disfigurement	an appearance that has been spoiled or is misshapen
binomial	of or relating to or consisting of two terms
newcomer	any new participant in some activity
unreason	the state of being irrational
burr	to remove the <unk> from
impound	to take temporary possession of as a security , by legal authority
keratin	a fibrous <unk> that occurs in the outer layer of the skin and in horny tissues such as hair , feathers , nails , and hooves
dalmatian	of or relating to dalmatia or its inhabitants
dilution	a diluted solution
individualism	a belief in the importance of the individual and the virtue of self - reliance and personal independence
beaker	used for chemistry
chaff	to be silly or tease one another
install	to set up for use
getting	to come into the possession of something concrete or abstract
ribbed	furnished or strengthened with ribs
gall	to irritate or vex
windjammer	a large sailing ship
polysyllabic	having or characterized by words of more than three syllables
epiphany	a divine manifestation
ensure	to make certain of
bone	to remove the bones from
beaked	having or resembling a beak
steadily	at a steady rate or pace
doze	to sleep lightly or for a short period of time
udder	the glandular organ in which milk is secreted and stored
credible	capable of being believed
communism	a scheme of equalizing the social conditions of life
formerly	at a previous time
plethora	extreme excess
stultify	to prove to be of unsound mind or demonstrate someones incompetence
beneficence	doing good
drab	lacking in liveliness or charm or surprise
numerically	in number
sneaker	a canvas shoe with a pliable rubber sole
demonstrable	necessarily or demonstrably true
bath	to clean ones body by immersion into water
ghat	stairway in india leading down to a landing on the water
germ	a small apparently simple structure as a fertilized egg from which new tissue can develop into a complete organism
syringa	large hardy shrub with showy and strongly fragrant creamy - white flowers in short terminal racemes
awe	an overwhelming feeling of wonder or admiration
amiable	disposed to please
rowboat	a boat designed to be propelled by oars instead of sails
van	a closed railroad car that carries baggage or freight
connote	to involve as a necessary condition of consequence
congeniality	a congenial disposition
assumed	adopted in order to deceive
platitude	a trite or obvious remark
diocese	the territorial jurisdiction of a bishop
fuchsia	any of various tropical shrubs widely cultivated for their showy drooping purplish or reddish or white flowers
madden	to cause to go crazy
neanderthal	ill - mannered and coarse and contemptible in behavior or appearance
tame	very restrained or quiet
preferment	the act of preferring
grasping	immoderately desirous of acquiring e . g . wealth
brawler	a fighter especially one who participates in <unk>
wax	to go up or advance
gin	to trap with a snare
viscous	having a relatively high resistance to flow
lurid	horrible in <unk> or savagery
vector	a variable quantity that can be resolved into components
hogshead	a british unit of capacity for alcoholic beverages
crushing	often used in combination
elate	to fill with high spirits
senility	the state of being senile
duly	at the proper time
outcrop	to appear on the surface , come to the surface on the ground
coke	carbon fuel produced by distillation of coal
sundry	consisting of a haphazard assortment of different kinds
gauss	the c
cathode	a negatively charged electrode that is the source of electrons entering an electrical device
mysterious	having an import not apparent to the senses nor obvious to the intelligence
construction	the act of constructing something
gore	to wound by piercing with a sharp or penetrating object or instrument
technician	someone whose occupation involves training in a specific technical process
deuce	a tie in tennis or table tennis that requires winning two successive points to win the game
corduroy	to build a road from logs laid side by side
candle	to examine eggs for freshness by holding them against a light
bilateral	having identical parts on each side of an axis
glottis	the vocal apparatus of the larynx
reproductive	producing new life or offspring
fabricate	to make up something artificial or untrue
syrinx	the vocal organ of a bird
bailment	the delivery of personal property in trust by the bailor to the bailee
whiplash	a quick blow delivered with a whip or whiplike object
smasher	a very attractive or seductive looking woman
indisposition	a slight illness
plutocrat	someone who exercises power by virtue of wealth
wastrel	waste land or common land
acetabular	of the cup - shaped socket that receives the head of the thigh bone
determent	a communication that makes you afraid to try something
dirty	soiled or likely to soil with dirt or grime
faded	having lost freshness or brilliance of color
palm	to touch , lift , or hold with the hands
mountain	a land mass that projects well above its surroundings
similar	marked by correspondence or resemblance
torus	a ring - shaped surface generated by rotating a circle around an axis that does not intersect the circle
monastic	of communal life sequestered from the world under religious vows
palate	the upper surface of the mouth that separates the oral and nasal cavities
russet	of brown with a reddish tinge
lobed	having deeply indented margins but with lobes not entirely separate from each other
forearm	to arm in advance of a confrontation
conundrum	a difficult problem
insistence	continual and persistent demands
watcher	a person who keeps a devotional vigil by a sick bed or by a dead body
crater	a bowl - shaped depression formed by the impact of a meteorite or bomb
critique	to appraise critically
replica	copy that is not the original
tuneless	not having a musical sound or pleasing tune
surveying	to consider in a comprehensive way
propane	colorless gas found in natural gas and petroleum
adversely	in an adverse manner
monotype	a taxonomic group with a single member a single species or genus
unteach	to cause to disbelieve
spousal	relating to a spouse
exhausting	producing exhaustion
yoga	hindu discipline aimed at training the consciousness for a state of perfect spiritual insight and tranquility that is achieved through the three paths of actions and knowledge and devotion
bedded	having a bed or beds as specified
suffuse	to cause to spread or flush or flood through , over , or across
corporation	a business firm whose articles of incorporation have been approved in some state
excretion	the bodily process of discharging waste matter
invalid	having no cogency or legal force
mattock	a kind of pick that is used for digging
activeness	the trait of being active
interested	having or showing interest
digital	displaying numbers rather than scale positions
warehouse	a storehouse for goods and merchandise
denotation	the act of indicating or pointing out by name
unwilling	not disposed or inclined toward
trash	to dispose of something useless or old
inattention	lack of attention
page	to contact , as with a <unk> or by calling somebodys name over a p . a . system
unbalanced	being or thrown out of equilibrium
subsidize	to secure the assistance of by granting a subsidy , as of nations or military forces
scrub	to clean with hard rubbing
quilting	to stitch or sew together
rabies	an acute viral disease of the nervous system of warm - blooded animals usually transmitted by the bite of a rabid animal
bacillus	found primarily in soil
stateroom	a guest cabin
enlargement	the state of being enlarged
drag	to pull , as against a resistance
deathbed	the last few hours before death
amorousness	a feeling of love or fondness
mealy	containing meal or made of meal
vigil	a period of sleeplessness
cleaver	a butchers knife having a large square blade
song	a short musical composition with words
seraphic	of or relating to an angel of the first order
dentifrice	a substance for cleaning the teeth
constrain	to hold back
structure	a thing constructed
consternation	fear resulting from the awareness of danger
faster	acting or moving or capable of acting or moving quickly
boudoir	a small room , especially if pleasant , or elegantly furnished , to which a lady may retire to be alone , or to receive intimate friends
invest	to make an investment
quandary	a situation from which extrication is difficult especially an unpleasant or trying one
remit	to send money in payment
untidy	not neat and tidy
feud	a bitter quarrel between two parties
complicate	to make more complicated
torrid	emotionally charged and vigorously energetic
ardently	in an ardent manner
stirrer	an implement used for stirring
corundum	very hard mineral used as an abrasive
tryout	trying something to find out about it
inaccuracy	the quality of being inaccurate and having errors
facultative	of or relating to the mental faculties
rinse	to wash off soap or remaining dirt
phlegm	expectorated matter
